#separator:tab
#html:true
#tags column:3

平城宮跡にある施設のうち、令和4年(2022)に復原されたのはどれか。	大極殿院南門	建築、彫刻、絵画
興福寺の堂塔のうち、令和5年(2023)1月現在、約120年ぶりに大規模な修理が行われているのはどれか。	五重塔	建築、彫刻、絵画
美しい檜皮葺の木造十三重塔がたち、紅葉の名所としても知られる寺社はどれか。	談山神社	建築、彫刻、絵画
吉野山の竹林院にある池泉回遊式庭園の名前はどれか。	群芳園	建築、彫刻、絵画
東大寺法華堂の不空羂索観音立像の背後に北面してまつられる塑像はどれか。	執金剛神立像	建築、彫刻、絵画
円成寺の国宝大日如来坐像を若き日に制作したという仏師は誰か。	運慶	建築、彫刻、絵画
秋篠寺の伎芸天立像のうち奈良時代の作であるのはどの部分か。	頭部	建築、彫刻、絵画
唐招提寺金堂の内陣中央にまつられる国宝の脱活乾漆像はどれか。	盧舎那仏坐像	建築、彫刻、絵画
長谷寺の本尊である木造十一面観音立像は、どの仏像の特徴を兼ね備えているか。	地蔵菩薩像	建築、彫刻、絵画
奈良県内にある神社本殿の建築形式として、最も多いものはどれか。	春日造	建築、彫刻、絵画
奈良市には高さ５m前後の国宝の木造五重小塔が２基伝わっている。一つは元興寺（極楽坊）にあるが、もう一つは

どこか。	海龍王寺	建築、彫刻、絵画
鎌倉時代に再建された東大寺南大門の建築様式はどれか。	大仏様	建築、彫刻、絵画
枯山水で奈良盆地の眺望を借景にした慈光院庭園を造ったと伝えられる茶人は誰か。	片桐石州	建築、彫刻、絵画
飛鳥寺の本尊で、飛鳥大仏と呼ばれている仏像はどれか。	銅造釈迦如来坐像	建築、彫刻、絵画
法隆寺大宝蔵院の奥にまつられている国宝の木造観音菩薩立像には、朝鮮半島にあった古代国家の名がつけられ

ている。その国の名はどれか。	百済	建築、彫刻、絵画
唐招提寺金堂の内陣中央にまつられた国宝の脱活乾漆像はどれか。	廬舎那仏坐像	建築、彫刻、絵画
円成寺の国宝大日如来坐像を若き日に制作したという仏師は誰か。	運慶	建築、彫刻、絵画
當麻寺に伝わる「當麻曼荼羅」に描かれるのは、次のどれか。	極楽浄土	建築、彫刻、絵画
法隆寺五重塔初層にある、仏教説話を表現した群像の造像法はどれか。	塑造	建築、彫刻、絵画
興福寺の阿修羅像についての記述のうち、正しいのはどれか。	胸飾りを付けている。	建築、彫刻、絵画
円成寺の国宝大日如来坐像を若き日に制作したという仏師は誰か。	運慶	建築、彫刻、絵画
室生寺金堂の国宝木造釈迦如来立像は、近世までどの如来としてまつられてきたか。	薬師如来	建築、彫刻、絵画
東大寺開山堂内の厨子に収められ、毎年12月16日に開扉される国宝の像はどれか。	良弁僧正像	建築、彫刻、絵画
僧の命蓮に関する奇跡物語を描いた、平安時代末期制作の絵画はどれか。	信貴山縁起絵巻	建築、彫刻、絵画
天理市の長岳寺に所蔵される、狩野山楽が描いた大幅の絵画は何を題材としているか。	地獄	建築、彫刻、絵画
薬師寺玄奘三蔵院の「大唐西域壁画」を描いた画家は誰か。	平山郁夫	建築、彫刻、絵画
東大寺南大門を望む場所にあり、国の名勝に指定された池泉回遊式庭園で知られるのはどれか。	依水園	建築、彫刻、絵画
