#separator:tab
#html:true
#tags column:3

江戸時代から「崇峻天皇陵」とも考えられている桜井市の大型方墳はどれか。	天王山古墳	遺跡、古墳
御所市にある全長約240mの前方後円墳「室大墓」とも呼ばれる古墳はどれか。	宮山古墳	遺跡、古墳
次の古墳のうち奥壁に石棚を造り付けているのはどれか。	岡峯古墳	遺跡、古墳
阿部丘陵にあり、竜山石製の大きな家形石棺が石室の内部に残る古墳はどれか。	艸墓古墳	遺跡、古墳
平城京のメインストリートである朱雀大路は、次のどの門から北にのびていたか。	羅城門	遺跡、古墳
桜井市にあり、舒明天皇建立の「百済大寺」とも推定されている寺院跡はどれか。	吉備池廃寺	遺跡、古墳
聖徳太子建立の由緒をもつ比曾寺の跡はどの町村にあるか。	大淀町	遺跡、古墳
大和国に勢力を張った松永久秀が佐保川の北側に築いた城の遺跡はどれか。	多聞城跡	遺跡、古墳
森野藤助の薬園を史跡指定した「森野旧薬園」はどの市町村にあるか。	宇陀市	遺跡、古墳
西日本で初めて環状の配石祭祀遺構（ストーンサークル）が見つかった吉野郡にある縄文遺跡はどれか。	宮の平遺跡	遺跡、古墳
出土した土器片の絵画に基づいて古代の楼閣が復原されている、弥生時代の遺跡はどれか。	唐古・鍵遺跡	遺跡、古墳
馬見丘陵公園にあり、東半分が築造当初の姿に復原されている全長106mの前方後円墳はどれか。	ナガレ山古墳	遺跡、古墳
次の記述のうち、誤っているのはどれか。	高松塚古墳では鮮やかな朱雀の壁画が見つかった。	遺跡、古墳
欽明陵近くの吉備姫王墓の墓域内に置かれた４体の石像は、何と呼ばれているか。	猿石	遺跡、古墳
出土した回廊が飛鳥資料館に復原展示されている寺跡はどれか。	山田寺跡	遺跡、古墳
明日香村の水落遺跡は中大兄皇子が造らせた何の施設の跡であると推定されているか。	漏刻台	遺跡、古墳
鎌倉時代の僧、忍性が難病の患者救済のために設けたことに始まる施設はどれか。	北山十八間戸	遺跡、古墳
昭和32年（1957）に縄文時代早期の押型文土器が出土した山添村の遺跡はどれか。	大川遺跡	遺跡、古墳
出土した回廊が飛鳥資料館に復原展示されている寺跡はどれか。	山田寺跡	遺跡、古墳
平城宮跡の復原大極殿の扁額に書かれた文字は、誰にゆかりのある文字を集めたものか。	長屋王	遺跡、古墳
平城宮建設にともなって前方部が削平された第二次大極殿北側の市庭古墳は、どの陵に治定されているか。	平城陵	遺跡、古墳
江戸時代に、崇峻陵とも考えられた桜井市の大型方墳はどれか。	天王山古墳	遺跡、古墳
明日香村平田にあって、猿石と呼ばれる４体の石像が置かれている墓はどれか。	吉備姫王墓	遺跡、古墳
明日香村稲淵にあり、明神塚と呼ばれていた墳墓は誰の墓とされているか。	南淵請安	遺跡、古墳
阿部丘陵にあり、竜山石製の大きな家形石棺が石室の内部に残る古墳はどれか。	艸墓古墳	遺跡、古墳
高取町佐田にあり、草壁皇子の墓と推測される終末期古墳はどれか。	束明神古墳	遺跡、古墳
