#separator:tab
#html:true
#tags column:3

ユネスコの世界遺産「古都奈良の文化財」の構成資産に含まれるのはどれか。	春日山原始林	観光
修験者が根本道場として開き、世界遺産に登録された、吉野山から熊野に達する参詣道はどれか。	大峯奥駈道	観光
次の街並みのうち、重要伝統的建造物群保存地区に選定されているのはどこか。	宇陀市松山地区	観光
夕日観音や朝日観音などの石仏がある滝坂道はどの街道の一部であるか。	柳生街道	観光
奈良盆地に多い環濠集落のうち、大和郡山市の史跡に指定されているのはどれか。	稗田環濠集落	観光
令和4年(2022)に開設された「なら歴史芸術文化村」はどの市にあるか。	天理市	観光
慶長12年(1607)の棟札をもち、建築年代が明らかな民家では日本最古とされる五條市の住宅はどれか。	栗山家住宅	観光
昭和29年(1954)に架橋された十津川村の谷瀬の吊り橋は長さ297mだが、川面からの高さは何mか。	54ｍ	観光
法隆寺を含む世界遺産の指定名はどれか。	法隆寺地域の仏教建造物	観光
世界遺産「紀伊山地の霊場と参詣道」として登録された、高野山と熊野本宮を最短距離で結ぶ熊野参詣道の名称はどれか。	小辺路	観光
称念寺を御坊として発展し、重要伝統的建造物群保存地区に指定された町はどこか。	今井町（橿原市）	観光
慶長12年(1607)の棟札によって建築年代が明らかな民家では日本最古とされる五條市の住宅はどれか。	栗山家住宅	観光
大峯山山上ヶ岳の登山基地としても知られる温泉はどれか。	洞川温泉	観光
昭和29年(1954)に架橋された十津川村の谷瀬の吊り橋は長さ297mだが、川面からの高さは何mか。	54m	観光
明治30年代に開通し、10年足らずで廃止された関西鉄道の加茂−奈良間の路線は「（）鉄道」の通称で親しまれた。（）にあてはまる言葉は次のうちどれか。	大仏	観光
高取町の土佐街道で平成19年(2007)から毎年行なわれている行事はどれか。	町家の雛めぐり	観光
毎年2月に開催される奈良公園周辺をLED等のあかりで演出する催しはどれか。	なら瑠璃絵	観光
世界遺産「古都奈良の文化財」の構成資産のうち、最も南に位置するのはどれか。	薬師寺	観光
1月現在、奈良県内に何ヶ所あるか。	3ヶ所	観光
慶長12年（1607）の棟札が見つかり、建築年代が明らかな民家では日本最古とされ、五條新町を構成する文化財となっている住宅はどれか。	栗山家住宅	観光
国営飛鳥歴史公園で、平成28年（2016）に開園した地区はどれか。	キトラ古墳周辺地区	観光
大峯山山上ヶ岳の登山基地としても知られる温泉はどれか。	洞川温泉	観光
平成21年（2009）にユネスコの「無形文化遺産」に登録された伝統芸能はどれか。	奈良市の題目立	観光
毎年２月に開催される奈良公園周辺をＬＥＤ等のあかりで演出する催しはどれか。	なら瑠璃絵	観光
高取町の土佐街道で平成9年（2007）から毎年行なわれている行事はどれか。	町家の雛めぐり	観光
法隆寺が世界遺産に登録されたのはいつか。	平成元年（1989）	観光
上記の法隆寺を含む世界遺産の指定名はどれか。	法隆寺と周辺文化財	観光
世界遺産「古都奈良の文化財」に含まれている寺院はどれか。	大安寺	観光
「紀伊山地の霊場と参詣道」として世界遺産に登録された大峯奥駈道を開いたといわれるのは誰か。	行基	観光
平成18年末現在、世界遺産は奈良県に３件あるが、日本全国では何件か。	13件	観光
奈良県には万葉集をテーマにした「奈良県立万葉文化館」があるが、その所在地はどこか。	奈良市	観光
次の都市の中で、奈良市と姉妹都市でないのはどれか。	キャンベラ	観光
平成18年5月、奈良文化財研究所飛鳥資料館で実物が展示されたキトラ古墳の壁画はどれか。	白虎	観光
保存されたＪＲ奈良駅の旧駅舎を利用して平成21年（2009）7月に開設された施設はどれか。	奈良市総合観光案内所	観光
世界遺産「紀伊山地の霊場と参詣道」のうち、大峯奥駆道は吉野山とどこを結ぶ修行の道か。	熊野三山	観光
世界遺産「法隆寺地域の仏教建造物」に含まれる法起寺にある国宝の塔はどの形式か。	三重塔	観光
近鉄奈良駅前の噴水の中に立つ赤膚焼の像は、どの僧侶をモデルとして制作されているか。	行基	観光
世界遺産として登録された「古都奈良の文化財」の８つの資産のうち、もっとも南に位置するのはどれか。	薬師寺	観光
称念寺を御坊として発展し、現在も江戸時代から昭和初期にかけての民家が多く残る重要伝統的建造物群保存地区はどこか。	今井町（橿原市）	観光
明治30年代に開通し、10年足らずで廃止された関西鉄道の加茂－奈良間の路線は「○○鉄道」の通称で親しまれた。○○にあてはまる言葉は次のうちどれか。	大仏	観光
世界遺産「紀伊山地の霊場と参詣道」に含まれない資産はどこか。	吉野神宮	観光
世界遺産「古都奈良の文化財」を構成する8つの資産に含まれるのはどれか。	春日山原始林	観光
平成22年（2010）から始まった「しあわせ回廊なら瑠璃絵」でライトアップされる場所はどこか。	興福寺五重塔	観光
平成22年（2010）の平城遷都1300年祭で、平城宮跡に新設された施設はどれか。	平城京歴史館	観光
現在、国特別史跡の平城宮跡の範囲内にないものはどれか。	田村第跡	観光
正倉院に伝わる、名香「蘭奢待」の一部を切り取ったといわれるのはだれか。	織田信長	観光
JR奈良駅旧駅舎である奈良市総合観光案内所の屋根の上に取り付けられているものはどれか。	相輪	観光
近鉄奈良駅前の噴水の中に立つ像は、どの僧侶をモデルとして制作されているか。	行基	観光
文化財保護法成立のきっかけとなったのは次のどれか。	昭和24年（1949）の法隆寺金堂火災	観光
奈良盆地に多い環濠集落のうち、大和郡山市の史跡に指定されているのはどれか。	稗田環濠集落	観光
世界遺産「古都奈良の文化財」に含まれるのは次のうちどれか。	元興寺	観光
世界遺産「法隆寺地域の仏教建造物」に含まれる法起寺にある国宝の塔はどの形式か。	三重塔	観光
文化財保護法成立のきっかけとなったといわれている出来事は次のどれか。	昭和24年（1949）の法隆寺金堂火災	観光
国の特別史跡に指定されている平城宮跡の範囲内にないものはどれか。	田村第跡	観光
平成22年（2010）に伝統的建造物群保存地区に選定されたのはどれか。	五條市五條新町	観光
奈良盆地に多い環濠集落のうち、大和郡山市の史跡に指定されているのはどれか。	稗田環濠集落	観光
平城遷都1300年祭で公開された第一次大極殿の四神と十二支の絵を描いた画家は誰か。	上村淳之	観光
万葉の世界をテーマにした「奈良県立万葉文化館」はどこにあるか。	明日香村	観光
夕日観音や朝日観音などの石仏がある滝坂道はどの街道の一部であるか。	柳生街道	観光
毎年2月に開催される奈良公園周辺をLED等のあかりで演出する催しはどれか。	なら瑠璃絵	観光
奈良県で催される次の行事のうち、最も歴史が新しいのはどれか。	なら燈花会	観光
法隆寺を含む世界遺産の指定名はどれか。	法隆寺地域の仏教建造物	観光
世界遺産「古都奈良の文化財」の構成資産に含まれていない寺院はどれか。	西大寺	観光
世界遺産となった大峯奥駈道を開いたとされるのは誰か。	役行者	観光
大峯山山上ヶ岳の登山基地としても知られる温泉はどれか。	洞川温泉	観光
橿原市今井町伝統的建造物群保存地区はその形成過程から次のどれにあてはまるか。	寺内町	観光
次の古い街並みのうち、門前町の性格を色濃く保つのはどれか。	桜井市初瀬	観光
吉野山と麓の千本口を結ぶ吉野ロープウェイは、どの特徴で日本一と言われるか。	国内で現役最古	観光
近鉄奈良駅前の噴水の中に立つ像は、どの僧侶をモデルとして制作されているか。	行基	観光
JR奈良駅旧駅舎である奈良市総合観光案内所の屋根の上に取り付けられているものはどれか。	相輪	観光
平成19年（2007）カンヌ国際映画祭でグランプリ（審査員特別大賞）に輝いた河瀬直美監督の映画の題名は何か。	殯の森	観光
世界遺産「古都奈良の文化財」に含まれるのはどの寺院か。	元興寺	観光
世界遺産「紀伊山地の霊場と参詣道」として登録された、高野山と熊野本宮を最短距離で結ぶ熊野参詣道の名称はどれか。	小辺路	観光
次の古い街並みのうち、門前町の性格を色濃く保つのはどれか。	桜井市初瀬	観光
JR奈良駅旧駅舎である「奈良市総合観光案内所」の屋根の上に取り付けられているものはどれか。	相輪	観光
吉野山と千本口を結ぶ吉野ロープウェイは、どの特徴で日本一と言われるか。	高低差が最大	観光
万葉の世界をテーマにした「奈良県立万葉文化館」はどの市町村にあるか。	明日香村	観光
「キトラ古墳壁画体験館」にはどのような名称がつけられているか。	四神の館	観光
