#separator:tab
#html:true
#tags column:3

墨の製法を日本に伝えたと『日本書紀』に記される高句麗の僧は誰か。	曇徴	工芸、特産品
幕末から明治期にかけて活躍した森川杜園は、どの伝統工芸の有名な作家であるか。	一刀彫	工芸、特産品
赤膚焼が焼かれてきた五条山はどの市にあるか。	奈良市	工芸、特産品
江戸時代に「南都随一」といわれ、奈良の名産として有名だったのはどれか。	晒	工芸、特産品
弘法大師がその製法を伝えたとされる、大和高原の特産品はどれか。	茶	工芸、特産品
三輪素麺の製造工程で行う「素麺干し」が見られる時期はいつか。	真冬	工芸、特産品
五條市が日本有数の生産量を誇り､博物館もある果物はどれか。	カキ	工芸、特産品
吉野山や洞川の土産物として知られる「陀羅尼助」とは何か。	薬	工芸、特産品
大和の特産品として知られる吉野葛は、原料に葛のどの部分を使うか。	根	工芸、特産品
江戸時代後期に活躍した、赤膚焼の作家は誰か。	奥田木白	工芸、特産品
幕末から明治期にかけて活躍した森川杜園は、どの伝統工芸の有名な作家であるか。	一刀彫	工芸、特産品
江戸時代に「南都随一」といわれ、奈良の名産として有名だったのはどれか。	晒	工芸、特産品
下市町の伝統工芸品として知られているものはどれか。	三宝	工芸、特産品
五條市大塔町惣谷で作られている生活用品はどれか。	坪杓子	工芸、特産品
吉野川沿いで和紙の産地として知られるのはどこか。	国栖	工芸、特産品
天川村洞川地区の特産品として知られ、役小角がその製法を伝えたとされるものはどれか。	陀羅尼助	工芸、特産品
三輪素麺の製法工程で行う「素麺干し」が見られる時期はいつか。	真冬	工芸、特産品
大和茶の特産地が集中している地域はどれか。	大和高原の北部	工芸、特産品
墨の製法を日本に伝えたと『日本書紀』に記される高句麗の僧は誰か。	曇徴	工芸、特産品
江戸時代に「南都随一」と称された「奈良晒」の原料はどれか。	麻	工芸、特産品
三輪素麺で知られる素麺の製造工程で行う素麺干しが見られる時期はいつか。	寒くて乾燥している真冬	工芸、特産品
弘法大師がその製法を伝えたとされる、大和高原の特産品はどれか。	茶	工芸、特産品
奈良市の伝統工芸品として知られるものはどれか。	筆	工芸、特産品
奈良の伝統工芸品や特産品についての記述のうち、正しいのはどれか。	奈良漬は、どぶろくの下に溜まる汁粕に野菜を漬けたのが起源である。	工芸、特産品
戦前から奈良県内で生産が確認されている「大和の伝統野菜」に含まれないのはどれか。	宇陀しいたけ	工芸、特産品
