#separator:tab
#html:true
#tags column:3

毎年5月に行われる「薪御能」は、興福寺のどのあたりで行われるか。	南大門跡	祭り、伝統行事
奈良市の率川神社で執り行われる通称「ゆり祭り」の正式名称はどれか。	三枝祭	祭り、伝統行事
8月15日に「大文字送り火」が行われる奈良市内の山はどれか。	高円山	祭り、伝統行事
奈良市の八柱神社で行われる、ユネスコの無形文化遺産に登録されている行事はどれか。	題目立	祭り、伝統行事
唐招提寺の「うちわまき」で撒かれるうちわの形はどれか。	ハート形	祭り、伝統行事
薬師寺で3月末に行われる「修二会」の通称はどれか。	花会式	祭り、伝統行事
砂を雨に見立てて激しくかけ合う「砂かけ祭り」が行われる神社はどれか。	廣瀬神社	祭り、伝統行事
12月に桜井市高田で行われる「いのこの暴れまつり」で主役となるのは誰か。	子ども	祭り、伝統行事
7月7日に行われる金峯山寺の「蓮華会」に着ぐるみで登場する動物はどれか。	カエル	祭り、伝統行事
飛鳥坐神社の｢おんだ祭り｣で、田植の所作の後に登場するのはどれか。	天狗とお多福	祭り、伝統行事
砂を雨に見立てて激しくかけ合う砂かけ祭りが行われる神社はどれか。	廣瀬神社	祭り、伝統行事
奈良県の無形民俗文化財に指定され、曽爾村の門僕神社に奉納される伝統芸能はどれか。	獅子舞	祭り、伝統行事
采女祭において花扇使いらを乗せた華やかな龍頭船を浮かべる池はどこか。	興福寺南の猿沢池	祭り、伝統行事
奈良市の八柱神社で行われる、ユネスコの世界無形文化遺産に登録されている行事はどれか。	題目立	祭り、伝統行事
2月の節分行事で参加者が「福は山」と唱するのはどこか。	大神神社	祭り、伝統行事
功徳により除災招福を祈る東大寺二月堂の「修二会」で、罪過を懺悔する対象となるのはどれか。	十一面観音	祭り、伝統行事
御所市の吉祥草寺で1月に催される火の行事は何か。	茅原のトンド	祭り、伝統行事
吉野の金峯山寺で7月7日に催される蓮華会の通称はどれか。	蛙とび	祭り、伝統行事
夏の奈良公園を彩る「なら燈花会」が始まったのはいつか。	平成11年（1999	祭り、伝統行事
7月7日の金峯山寺蓮華会に着ぐるみで登場する動物はどれか。	カエル	祭り、伝統行事
砂を雨に見立てて激しく掛け合う「砂かけ祭り」が行なわれる神社はどこか。	廣瀬神社	祭り、伝統行事
奈良県の「無形民俗文化財」に指定され、曽爾村の門僕神社に奉納される伝統芸能はどれか。	獅子舞	祭り、伝統行事
東大寺二月堂の「修二会」を創始した僧侶は誰か。	実忠	祭り、伝統行事
橿原市東坊城町で8月15日の伝統行事「ホーランヤ」で燃やされるのはどれか。	松明	祭り、伝統行事
天理市の大和神社で毎年4月1日に行なわれる祭りはどれか。	ちゃんちゃん祭り	祭り、伝統行事
薬師寺で3月末に行なわれる「修二会」の通称はどれか。	花会式	祭り、伝統行事
御所市の吉祥草寺で行なわれる行事についての記述のうち、誤りはどれか。	大きな御輿が境内でぶつかり合う。	祭り、伝統行事
