#separator:tab
#html:true
#tags column:3

石舞台古墳は、誰の墓の可能性が高いといわれているか。	蘇我馬子	特集
真の「文武天皇陵」ともいわれる中尾山古墳の墳形はどれか。	八角形	特集
高松塚古墳の壁画が発見されてから、令和4年(2022)で何周年を迎えたか。	50周年	特集
キトラ古墳の石室天井の中央に描かれているのはどれか。	天文図	特集
次の古墳のうち、令和4年(2022)に幾何学的な墳丘が整備されたのはどれか。	牽牛子塚古墳	特集
明日香村に点在する多くの石造物のうち、橘寺の境内にあるのはどれか。	二面石	特集
飛鳥寺本堂の西方約100ｍにある花崗岩製の五輪塔は誰の首塚だと伝えられているか。	蘇我入鹿	特集
飛鳥坐神社の「おんだ祭り」で、田植えの所作の後に登場するのはどれか。	天狗とお多福	特集
次の市町のうち、明日香村に行政区域が接していないのはどれか。	斑鳩町	特集
国営飛鳥歴史公園で、平成28年(2016)に開園した地区はどれか。	キトラ古墳周辺地区	特集
薬師寺は天武天皇が、皇后の病気平癒を願って創建したことに始まるが、皇后とはのちの誰か。	持統天皇	特集
建武新政の事績を讃えて、後醍醐天皇を祀る吉野神宮が創建されたのはいつか。	明治時代	特集
金峯山寺の中心堂である本堂の一般的な呼称はどれか。	蔵王堂	特集
吉野山にあり、文禄3年（1594）に豊臣秀吉が花見の本陣としたのはどれか。	𠮷水神社	特集
本堂の扉に楠木正行の辞世の歌が刻まれ、後醍醐天皇陵が隣接する吉野町の寺院はどれか。	如意輪寺	特集
本堂の扉に楠木正行の辞世の歌が刻まれ、後醍醐天皇陵が隣接する吉野町の寺院はどれか。	如意輪寺	特集
源義経が身をひそめたという蹴抜塔（義経隠れ塔）がある、吉野町の神社はどれか。	金峯神社	特集
西行法師が隠れ住んだという「西行庵」があるのは吉野山のどの場所か。	奥千本	特集
世界遺産「紀伊山地の霊場と参詣道」のうち、大峯奥駈道は吉野山とどことを結ぶ修行の道か。	熊野三山	特集
吉野山の桜の種類で最も多いのはどれか。	シロヤマザクラ	特集
吉野山や洞川の土産物として知られる「陀羅尼助」とは何か。	薬	特集
